10 10 10 10 10 10 10 10 10 10 10 10 10 10 10 10
10 01 01 01 00 00 00 00 00 00 00 00 00 00 00 10
10 01 00 00 00 00 00 00 00 00 00 00 00 00 00 10
10 00 00 00 00 00 10 00 00 00 00 00 00 00 00 10
10 00 00 00 00 00 10 00 00 00 00 00 00 00 00 10
10 00 00 00 00 00 10 00 00 00 00 00 00 00 00 10
10 10 10 10 10 10 10 00 00 00 00 00 00 00 02 10
10 00 00 00 00 00 00 00 00 00 00 00 00 02 02 10
10 00 00 00 00 00 00 00 00 00 00 02 02 02 02 10
10 00 00 00 00 00 00 00 00 02 02 02 02 02 02 10
10 00 00 00 00 00 00 00 02 02 02 02 02 02 02 10
10 10 10 10 10 10 10 10 10 10 10 10 10 10 10 10